Name,Amount,Type,Date,Balance
Income,350.0,Income,2024-09-19,350.0
Food,-12.0,Food,2024-09-19,338.0
Income,12.0,Income,2024-09-19,350.0
shirt,-12.0,Clothing,2024-09-19,338.0
Income,3000.0,Income,2024-09-19,3338.0
Income,3000.0,Income,2024-09-19,6338.0
Income,3000.0,Income,2024-09-19,9338.0
Income,30000.0,Income,2024-09-19,39338.0
Food,-130923.0,Food,2024-09-19,-91585.0
Income,91585.0,Income,2024-09-19,0.0